111111,11111,11111111,111111111
100,,,,,,,,,,,,,0000000000110000000000001
1011110111110110111110111101
1011110111110110111110111101
1000000000000000000000000001
1011110101111111111010111101
1000000101000110001010000001
1111110100000110000010111111
1111110111221111221110111111
1000000111221111221110000001
1011110111221111221110111101
1011110222222222222220111101
1000000222222222222220000001
1110110111221111221110110111
1110110111221111221110110111
1110110111221111221110110111
1110000000000000000000000111
1111110110111111110110111111
1111110110111111110110111111
1111110110000110000110111111
1000000110110110110110000001
1011110110110110110110111101
1010000000110110110000000101
1010010110000000000110100101
1000010111011111101110100001
1111110111011111101110111111
1111110111000000001110111111
1110000000011111100000000111
1000110111111111111110110001
1011110111111111111110111101
1000000000000000000000000001
1111111111111111111111111111
